11111111111111111111111111111111111111111111111111111111111111111111
1E0000000000000C00000C0000000000011010010100100000101001000000010101
10100101001000001010010000000101000000000000000000CC0000000C00000001
10100100101010100010010000000101011010010100100000101001000000010101
1P0000000C00C0000000000000000000C110100101001000001010010000C0010101
11111111111111111111111111111111111111111111111111111111111111111111
