1111111
101CPC1
110CC01
1001C01
1ECCC01
1000C01
1111111
