1111111111
101000C001
1001000001
1CC0100001
10E0010001
10C0001001
10C0000001
10P0100101
10C1001001
1111111111